11111111111111111111111111111111111111111111111111
1E000000000000000000000000000000000000000000000001
11111111111111110001111111111111111111111110000001
10000010000000010000000000000000000000000000000001
10000010000000010000000000000000000000000000000001
10000010000000000001000000000000000000000000000001
10000010000000000001000000000000000000000000000001
10000010000000000001000000000000000000000000000001
10000010000000000001000000000000000000000000000001
10000010000000000001001110111111111111100000000001
10000010000000000001000000001000000000100000000001
10000010000000000001000100000100000000100000000001
10000010000000000001000011000010000000100000000001
10000000000000000001001000100001000000100000000001
10000000000000000001001000000000100000100000000001
10000000001000000001001000000100010000000000000001
10000000001000000001001000001000001000111110000001
11111111111000000000001000010000000001100000000001
10000000001000000000001111111111111111000000000001
10100000001000000000000000000000000001000100000001
10101111111111111111111111111111111111000100000001
10100000000000000000000000000000000000000100000001
1S100000000000000001111111111100000000000100000001
11111111111111111111111111111111111111111111111111