11111111111111111111111111111111111111111111111111
1100000100000000000000000000E111111110000000000111
11011111000000001111111111111111111110000000000111
1000011111111100000C000000000000000110001111110111
10010000011100000000000000000000000110001111110111
10010000111111111111111111111100000110001111110111
1001000011000000000111100000000C000000000000110111
10010000110000001111111111111110000000000111000011
11111100000000000000000011111110000000001111011111
11111100000000001111111111111110000000011110011111
1000000C000000000000000000111110000000111100111111
1000011111111111111111000000001C000001111101111111
100000000000000000011100000000C0000000000000000001
10111100011111000001111111111111111111100000000001
10111100011111000000000000000000000000100000000001
101111000111110000000000000000000#0000100000011111
10111100011111111111111111111111110000000000011111
10111100000000000000000000011111110000111111111111
1S111100000000000000000000011100000000111111111111
11111111111111111111111111111111111111111111111111