11111111111111111111111111111111111111111111111111
1100000100000000000000000000E111111110000000001111
11011111000000001111111111111111111110000000001111
10000001111111000000000000000000000110001111111111
10010000011100000000000000000000000110001111111111
10010000111111111111111111111100000110001111111111
10010000110000000001111000000000000000000000111111
10010000110000001111111111111110000000000111111111
11111100000000001111111111111110000000001111111111
11111100000000001111111111111110000000011111111111
100000C0000000000000000000111110000000111111111111
10000011111111111111110000000010000001111111111111
10000000000000000000110000000000000000000000000001
10011100011111000000111111111111111111100000000001
10011100011111000000000000000000000000100000000001
100111000111110000000000000000000#0000100000011111
10011100011111111111111111111111110000000000011111
10011100000000000000000000011111110000111111111111
1S011100000000000000000000000000000000111111111111
11111111111111111111111111111111111111111111111111