11111111111111111111111111111111111111111111111111
111111111111##11111110000000E111111111111111111111
111111111111##111111100000000111111111111111111111
10000001111111000000000000000000000111111111111111
10000000000000000000000000000000000111111111111111
10000000011111111111111111111100000111111111111111
10000000000000000000000000000000000000000000000001
10000000000000001111111111111110000000000000000111
11111100000000001111111111111110000000000000000111
11111100000000001111111111111111000000000000000111
10000000000000000000000000111111000000111111111111
10000011111111111111100000000000000000111111111111
10000000000000000000000000000000000000000000000001
10000000000000000000011111111111111111100000000001
11111111111111111111111111111111111111111111111111