11111111111111111111111111111111111111111111111111
1E00000000000L00000100000000000L001000000000000001
11011111111111110011100000100001110000000001000001
10000010000000010010000000100000000100000010000001
11111010000000010000000000100M00000100000100000001
10000010000000010001111111111111111111100000000001
10111010000100000001000000000000010000000000100001
100000100001011100U1000000000010000010001000000001
10000010000100000001000000000000010000000001000001
100111100011000000010D1110111111111111100000000001
10000011101111000001000000001000000M00100000000001
11110010000000000001000100000100000000100000010001
10000011100000000001000011000010000000100000000001
10000010111111100001001000100001000000100001000001
10000010000000100001001000000000100000100000010001
10000000001000000001001000000100010000000000000001
1000000U001R00000001001000001000001000111110000001
11111111111000000000001000010000000001100000000001
10000000001000000000001111111111111111000000000001
10100000001000000000000000000000000001000100000001
10101111111111111111111111111111111111000100000001
10100000000000000000000000000000000000000100000001
1S100000000000000001111111111100000000000100000001
11111111111111111111111111111111111111111111111111