11111111111111111111111111111111111111111111111111
10000000010000000000000000000000000000000000000001
10000100010000110011111011110111111111110000000001
10111100010000000011111001100111110000000000100001
10000100010000010010000000000000000000000000100001
10001110010000010010011111111111111111111111100001
10001010010000010000000000000000000000000001000001
10001010010000010110000000111111111100000001011111
10001010000000010000000000100000000100000001000001
10001010100000011100111111100000000100000001111101
11111010100000000000000000100000000111111001000001
10000010010000000000000000111001000100010001011111
100000000100000000000000S0100001000100010001000001
10000100111111111111111111100001000100011001111101
1001010000M000100000001110100001001100110001000001
100011000M0000100000000000100011000100000001000001
10000111111010100011101110100001000100000001110001
10000000000100100010000011100111000100000001000001
100M00001110001000100E0010100001000000000001000001
11111111000100110111111110111001000000000001000001
10000000000100100000000000000001000001111000000001
10000101111101111100000100000001000000001111000001
10000001000000000000011100000001000000001000000001
11111111111111111111111111111111111111111111111111