11111111111111111111111111111111111111111111111111
1000001001000001000E010010000000000000000000000001
101000100100000R0000110000010000110000000000000001
10110000000000010000011100111000110000000000000001
101110100100000111U1110000010000110000000000000001
10001010010000000000000010000000110000000000000001
10001111011111111111111111111111111111111111111011
11100001000000000000000110000010001000010010010011
1000000100000M000000000000000010000001000000010111
10111001110000000000000011000010000010111100010001
1000111101000000011111001100001000M010000000010101
10000000000011110000110011110000000111100000010001
1000111111111001000111111000000001111M000111110101
11100000000000010010000001100100010010111000001001
10000110000001111111000010010100000010000011111001
10000110000001000000100100010011111111110100001001
11111111111111110000110000010000001000000100001001
10000000000000000M00000000010000001001000001111101
10101101000001000011111000011110011100011000001001
10101001000001000010010111100000000100001100001001
10101001000001111110010000100111000100000100111001
10101001011100000010000100001001000100000100000001
1S100000000100000000010001000001000000000000000001
11111111111111111111111111111111111111111111111111