11111111111111111111111111111111111111111111111111
1100000100000000000000000000E1111011110000K0001111
11011111000000001111111111111111001110000000001111
10000110100111GG0000000000000000000110001110011111
10010000011100000000000000000000000110001110000111
10010000111111111111101111111100000110001111100111
10010000110000000001101000000000000000000000100111
10010000110000001111101110000110000000K00101100111
11111100000011100000000000000110000000001101100111
11111100000000001111111000111110000000011100000111
10000000000R000000000000001100000K0000011100111111
10000011111111111111110000000010000001111100111111
100000000L0000000100110000000000000100000000000001
10111100010101000100111111111111111111100000000001
10111100010101000100000000000000000100100000000001
1000R0000000010000000000000000000#0000100000011011
10111100010101111111111111111111110000000000011011
10111100010100000000000000011111110000111110011011
1S111100000000000000000000011100000000000000011111
11111111111111111111111111111111111111111111111111