11111111111111111111111111111111111111111111111111
1000001000000001000E010001000100R00001000000000011
1##0##0000P0000H0100000100010000R00001111110000001
100#0010000000111111111111111100110001000000001111
1##0#01000011U000000000010R0000010000000R000000001
10#1111110000000L00000001R0000101000011110000000L1
10000010000000001111111111111011100001010001111111
11110010000110000000000010000001111001010001000001
10R00010R0000000000M00001R000000000001000100000001
11110011111000111111111111111111111111000111100111
10000010000000000000000010000100000000000000000001
100011D1110000000000000101000100001100000100000001
100001000000000000001110000100000000011111000U0001
100001000111000001111000000001111000U0000100000001
11100#000000011111000000000M0000111110000100000001
1000100000111100000111111111111000001111000000L001
1S00100000000000000000000000000000000000000000L001
11111111111111111111111111111111111111111111111111