11111111111111111111111111111111111111111111111111
1000000001M000000000000000000000000000000000000001
10000100010000110011111011110111111111110000000001
10111100010000000011111001100111110000000000100001
10000100010000010010000000000000000000000000100001
10001110010000010010011111111111111111111111100001
10001010010000010000000000000000000000000001000001
10001010011000010110000000111111111100000001011111
10001010001000010000000000100000000100000001000001
10K01010100000011100111111100000000100000001111101
111110101000000000K0000000100000000111111001000001
10000010010000010000000000111001000100010001011111
10M000000100000100000000S0100001000100010001000001
10000100111111111111111111100001000100011001111101
1001010000M000100000001110100001001100110001000001
100011000M0000100000000000100011000100000001000001
10000111111010100011101110100001000100000001110001
100000000001001000100000111001110001000000010000L1
100M00000111001000100E00101000010000G00000010000L1
111111110001DD1101111111101110010000G0000001000001
10100000000100100000000000LR0001000001111000000001
1010010110110011110000010U000001000000001111000001
10000011000000000000L111000000010000000010000UUUU1
11111111111111111111111111111111111111111111111111