11111111111111111111111111111111111111111111111111
1100000100000N00000000000000E1111011110000K0001111
11011111000000001111111111111111001110000000001111
10000110100111GG00000H0000000000000110001110011111
100100000111000000000H0000000000000110001110000111
1001000011111111111110111111110000011BBB11111BB111
100100001100000000011010000#0000000000000000100111
1001000011000000111110111000011000#00000P101100111
11111100000011100000000000000110000000001101100111
11111100000000001111111000111110000000011100000111
10000000000R00000000000000110000000000011100111111
100#0011111111111111110000000010000001111100111111
100000000L00000001001100000000000#0100000100000001
10111100010101000100111111111111111111100100000001
101111000101010001000000000000000001001001000Q0001
1000R00000000100000000L000000000000000100100011011
10111100010101111111111111111111110000000100011011
101111000101000000000000000111111100M0111110011011
1S111100000000000000000000011100000000000000011111
11111111111111111111111111111111111111111111111111