11111111111111111111111111111111111111111111111111
1000001000000001000E010001000100R00001000000000011
10000000001000000100000100010000R00001111110000001
10000010000000111111111111111100110001000000001111
10000010000111000000000010000000100000000000000001
10011111100000000000000010000010100001111000000001
10000010000000001111111111111011100001010001111111
11110010000110000000000010000001111001010001000001
1000001000000000000000001R000000000001000100000001
11110011111000111111111111111111111111000111100111
10000000000000000000000010000100000000000000000001
10001101110000000000000101000100001100000100000001
10000100000000000000111000010000000001111100000001
10000100011100000111100000000111100000000100000001
11100000000001111100000000000000111110000100000001
10001000001111000001111111111110000011110000000001
1S001000000000000000000000000000000000000000000001
11111111111111111111111111111111111111111111111111