111111111111111111111111111111111111111111111111111111111111
111111111111111111111111111111111111111111111111111111111111
100000000111111111111111111111111111111111111111111111111111
100000000111111111111111111111111111111111111111111111111111
111111111111111111111111111111111111111111111111111111111111
111111111111111111111111111000000000000000000000000000011111
100000000000000000000000000000000000000000000000000000011111
100000000000000000000000000000000000000000000000000000011111
111111111111111111111111111111111111000001111111111111111111
111111000000000000000000000000000000000000000000000000011111
111111000000000000000000000000000000000000000000000000011111
111111000000001111111111111000000000000000000000000000011111
111111111111111111111111111000000000000000000000000000011111
111111111111111111111111111111111111111111111111111111111111