 _      _____ _   _ _____ _     
| |    |  ___| | | |  ___| |    
| |    | |__ | | | | |__ | |    
| |    |  __|| | | |  __|| |    
| |____| |___\ \_/ / |___| |____
\_____/\____/ \___/\____/\_____/
                                