11111111111111111111111111111111111111111111111111
1100000100000000000000000000E1111011110000K0001111
11011111000000001111111111111111001110000000001111
10000110100111GG00000000000000000GG110001110011111
10010000011100000000000000000000000110001110000111
10010000111111111111101111111100000110001111100111
100100001100000000011010000#0000000000000000100111
1001000011000000111110111000011000#000000101100111
11111100000011100000000000000110000000001101100111
11111100000000001111111000111110000000011100000111
10000000000R00000000000000110000000000011100111111
10000011111111111111110000000010000001111100111111
100000000L00000001001100000000000#0100000000000001
10111100010101000100111111111111111111100000000001
10111100010101000100000000000000000100100000000001
1000R00000000100000000L000000000000000100000011011
10111100010101111111111111111111110000000000011011
10111100010100000000000000011111110000111110011011
1S111100000000000000000000011100000000000000011111
11111111111111111111111111111111111111111111111111