 _____ _____ 
|  _  |  ___|
| |/' |___ \ 
|  /| |   \ \
\ |_/ /\__/ /
 \___/\____/ 
             