 _____    ___ 
|  _  |  /   |
| |/' | / /| |
|  /| |/ /_| |
\ |_/ /\___  |
 \___/     |_/
              