11111111111111111111111111111111111111111111111111
1000000001M00000000000000000D000000000000000000001
10000100010000110011111011110111111111110000000001
101111000100000000111110011001111100000000001000L1
1000010001000001001R0000000000000000000000001R0001
100011100100000100100111111111111111111111111000L1
10001010010000010000000000000000000000000001000001
10001010011000010110000000111111111100000001011111
10001010001000010000000000100000000100000001000001
10K01010100000011100111111100000000100000001111101
111110101000000000K0000000100000000111111001000001
10000010010000010000000000111001000100010001011111
10#000000100000100000000S0100001000100010001000001
10000100111111111111111111100001000100011001111101
1001010000L000100000001110100001001100110001000001
1000110R000000100000000000100011000100000001000001
10000111111110100011101110100001000100000001110001
10000000000100100010000011100111000100111111000001
100M00000111001000100E00101000010000G0G00001000001
111111110001DD1101111111101110010000G01K0001000001
10100000000100100000000000LR0001000001111000000001
1010010110110011110000010U000001000000001111000001
10000011000000000000L1110000000100N0000010000UUUU1
11111111111111111111111111111111111111111111111111