 _____  __  
|  _  |/  | 
| |/' |`| | 
|  /| | | | 
\ |_/ /_| |_
 \___/ \___/
            