 _____  _____ 
|  _  ||____ |
| |/' |    / /
|  /| |    \ \
\ |_/ /.___/ /
 \___/ \____/ 
              