11111111111111111111111111111111111111111111111111
1EH0000000000L00000100000000000L01100#0#0000000001
1101111111111111001110000010000111P0#0#0#001000001
10000010M000000100100000001000000111#00#0#11000001
11111G10000000010000000000100M000001#0##0001000001
10000K10000000010001111111111111111111111111000001
10111110000100000001000000000000010000000000100001
100000100001011100U1000000000010000010001000000001
10000010000100000001000000000000010000000001000001
1001111000110K0000010D1111111111111111100000000001
1U000011101111000001000000001000000M00100000000001
11110010000000000001000100000100000000100000010001
10000011100000000001000011000010000000111100000001
10000010111111100001001000100001000000100001000001
10000010000000100001001000000000100000100000010001
10000000001000000001001000000100010000000R00000001
1000000U001R00000001001000001000001000111110110001
11111111111000000000GG10M0010000000001100000010001
10000000001000U00000001111111111111111000000010001
101000L00010R0000000000000G00000000001000100010001
10101111111111111011111111G11111111111000100110001
10100000000000000000000000G00000000000000100100001
1S100000000000000000000000G111000000000UU100000001
11111111111111111111111111111111111111111111111111