11111111111111111111111111111111111111111111111111
1000001001001001100E010010010000000000000000000001
1010001001010000010011000001R000111111111111111101
101100000G00000#0100011100111BBB110000000000000001
10111010010000001101110000010000110111111111111111
10001010010U0U00000000001001K0U0110000000000000001
10Q01111011111111111111111111111111111111111111011
1110000100000000000000D110000010001000010N100G0011
100000010000000000000000000000001000010BBBB00G0111
10111Q01110000000000000011R000001111111111000G0001
100011110100#00#00111110011R0001110M01000000010101
1R000000000011110000000011110000000111100000010001
100B1111BB111001000111111000001001110M000111110101
1110000000000001UU10000001100100010010111000001001
10000110000001111111000010010100000010#00011111001
10N001100MMM01000000100100010110011110110100001001
11111111111111110000110000010000001000000100001001
1000000000L0000000000000M0010000001001101101111101
10101101000001000011111000011110011100011000001001
1010100100#001000010010111100000000101101100001001
101010#1000001111110010000100111000101000100111001
1010100101110000001000010000100100010#000100000001
1S1000000001U0000000010001000001000000000000000001
11111111111111111111111111111111111111111111111111